0 153 0;
0; 0; 0;
0; 0; 1;
0; 1; 0;
0; 2; 1;
0; 1; 2;
0; 2; 2;
0; 3; 2;
0; 3; 1;
0; 3; 0;
0; 2; 0;
0; 4; 0;
0; 4; 1;
0; 4; 2;
0; 0; 2;
1; 6; 1; 1; 1; test;
1; 0; 8; 18; 8; firstMap.txt;